###############################################################
#     p                                                       #
#                                                             #
#                                                             #
#                                      g                      #
#                                                             #
#                                                             #
###############################################################
