###############################################################
#     p                                                       #
#                                                             #
#        g                                                    #
#                                                             #
#                                                             #
#                                                             #
###############################################################
