##########################
#                  #     #
#  p               #     #
#                  D     #
#          g       #     #
#  c               #     #
#                  #    c#
##########################
