##########################
#                  #     #
#  p               #     #
#                  D     #
#          g       #     #
#  c               #     #
#                  #     #
##########################
