##########################
#                  #     #
#  p               #     #
#                  D     #
#          g       #     #
#                  #     #
#                  #     #
##########################
